10 2
2 10
0 13, 2 13, 2 11, 0 11
3 13, 6 13, 6 11, 3 11
7 14, 7 13, 9 13, 9 14
9 13, 9 11, 11 11, 11 13
0 10, 1 10, 1 7, 0 7
0 6, 1 6, 1 3, 0 3
0 2, 1 2, 1 1, 11 1, 11 0, 0 0
2 9, 2 3, 10 3, 10 10, 3 10, 3 9