0 0
10 10
2 0, 3 0, 3 5,2 5, 2 6, 3 6, 3 12, 2 12
4 0, 5 0, 5 3, 4 3, 4 4, 5 4, 5 9, 4 9
6 1, 7 1, 7 4, 6 4, 6 5, 7 5, 7 7, 6 7
6 8, 7 8, 7 12, 6 12
8 3, 9 3, 9 11, 8 11