5 4
0 13
2 0, 7 0, 7 1, 3 1, 3 3, 2 3
2 4, 3 4, 3 6, 5 6, 5 8, 2 8
1 9, 1 12, 5 12, 5 9
5 9, 5 8, 7 8, 7 9
6 6, 6 7, 10 7, 10 6
8 5, 8 1, 9 1, 9 5